1111111111111111111
1000000000000000001
1000000000000000001
1000000000000000001
1000000000000000001
1000000000000000001
1000000000000011111
1000000000000000001
1111100000000000001
1000000000000000001
1111111111111111111