11111111111111111111
100000R0R00R00R00001
10000000000000000001
10000000P000000000R1
10000001110000000001
100000000000000000R1
10000000000000111111
10R000000000000000R1
11111000R00R0R000001
11111111111111111111